!!ATOK_TANGO_TEXT_HEADER_1
あーらん	アーラン	固有人他
あすたー	アスター	固有人他
ゔぇると	ヴェルト	固有人他
かふか	カフカ	固有人他
くらーら	クラーラ	固有人他
すゔぁろーぐ	スヴァローグ	固有人他
さんぽ	サンポ	固有人他
じぇぱーど	ジェパード	固有人他
せーばる	セーバル	固有人他
なたーしゃ	ナターシャ	固有人他
ふっく	フック	固有人他
ぶろーにゃ	ブローニャ	固有人他
ぺら	ペラ	固有人他
へるた	ヘルタ	固有人他
るか	ルカ	固有人他
りんくす	リンクス	固有人他
みつきなのか	三月なのか	固有人他
たんこう	丹恒	固有人他
ていうん	停雲	固有人他
じん	刃	固有人他
ひめこ	姫子	固有人他
げんきょう	彦卿	固有人他
ぎょくう	御空	固有人他
けいげん	景元	固有人他
びゃくろ	白露	固有人他
ふげん	符玄	固有人他
すしょう	素裳	固有人他
らせつ	羅刹	固有人他
ぎんろう	銀狼	固有人他
せいじゃく	青雀	固有人他
いんげつ	飲月	固有人他
けいりゅう	鏡流	固有人他
とぱーず	トパーズ	固有人他
けいないふん	桂乃芬	固有人他
せつい	雪衣	固有人他
かんあ	寒鴉	固有人他
ふぉふぉ	フォフォ	固有人他
あるじぇんてぃ	アルジェンティ	固有人他
どくたーれいしお	Dr.レイシオ	固有人他
ぶらっくすわん	ブラックスワン	固有人他
みーしゃ	ミーシャ	固有人他
はなび	花火	固有人他
ゔぇるとよう	ヴェルト・ヨウ	固有人他
さんぽこーすき	サンポ・コースキ	固有人他
じぇぱーどらんどぅ	ジェパード・ランドゥ	固有人他
せーばるらんどぅ	セーバル・ランドゥ	固有人他
ぶろーにゃらんど	ブローニャ・ランド	固有人他
りすしょう	李素裳	固有人他
べりたすれいしお	ベリタス・レイシオ	固有人他
あいおーん	星神	固有一般
きょすうのき	虚数の樹	固有一般
ばんかいのがん	万界の癌	固有一般
せいかく	星核	固有一般
れっかい	裂界	固有一般
しんさくしょうぐん	神策将軍	固有一般
むがんしょうぐん	無眼将軍	固有一般
たいぼく	太卜	固有一般
ぼくしゃ	卜者	固有一般
うんきぐん	雲騎軍	固有一般
たいぼくし	太卜司	固有一般
ちこうし	地衡司	固有一般
たんていし	丹鼎司	固有一般
こぞく	狐族	固有一般
じみょうぞく	持明族	固有一般
うちゅうすてーしょんへるた	宇宙ステーション「ヘルタ」	固有一般
やりーろ6	ヤリーロ-VI	固有一般
やリーろしっくす	ヤリーロ-VI	固有一般
せんしゅう	仙舟	固有一般
らふ	羅浮	固有一般
ぴのこにー	ピノコニー	固有一般
てるみぬす	テルミヌス	固有一般
りゅう	龍	固有一般
うろぼろす	ウロボロス	固有一般
あきゔぃり	アキヴィリ	固有一般
ぬーす	ヌース	固有一般
しぺ	シペ	固有一般
いどりら	イドリラ	固有一般
たいずるす	タイズルス	固有一般
みゅとぅす	ミュトゥス	固有一般
ふー	互	固有一般
くりふぉと	クリフォト	固有一般
ふり	浮黎	固有一般
ないん	IX	固有一般
やくし	薬師	固有一般
らん	嵐	固有一般
なぬーく	ナヌーク	固有一般
あっは	アッハ	固有一般
そんご	存護	固有一般
ほうじょう	豊穣	固有一般
ちょうわ	調和	固有一般
きょむ	虚無	固有一般
じゅんしゅ	巡狩	固有一般
ちえ	知恵	固有一般
かいめつ	壊滅	固有一般
もぎうちゅう	模擬宇宙	固有一般
ぎじかがく	疑似花萼	固有一般
ぎょうけつきょえい	凝結虚影	固有一般
しんしょくとんねる	侵蝕トンネル	固有一般
れきせんよいん	歴戦余韻	固有一般
ぼうきゃくのにわ	忘却の庭	固有一般
こんとんのにわ	混沌の庭	固有一般
きょこうじょじ	虚構叙事	固有一般
うちゅうのこうがい	宇宙の蝗害	固有一般
おうごんときかい	黄金と機械	固有一般
こうえんすい	光円錐	固有一般
いぶつ	遺物	固有一般
おうじつのむか	往日の夢華	固有一般
せいぎょく	星玉	固有一般
うんらく	殞落	名詞
