!Microsoft IME Dictionary Tool
!Version:
!Format:WORDLIST
!DateTime: 2026年02月20日 12:00

! このファイルは MITライセンスです。詳細はGitHub上のリポジトリを参照してください。
! https://github.com/Umichang/hsr-ime-dic

! 主な更新
! ver.20260220: ver.4.0本編まで
! ver.20260209: ver.4.1ティザー情報まで
! ver.20250825: ver.3.6ティザー情報まで
! ver.20241123: ver.2.7予告番組の内容を反映
! ver.20241103: ver.2.6の予定情報まで
! ver.20240911: ver.2.5前期まで
! ver.20240814: 色々不便があったものを増やした。ver.2.4前期まで
! ver.20240624: 実はあづさかなんだって。ver.2.3前期まで
! ver.20240322: あずさかって読めないよね
! ver.20240319: ピノコニー対応開始
! ver.20230705: 初版。読み間違ってるのあるかも？

! キャラクター名（通常）
あーらん	アーラン	人名	
あすたー	アスター	人名	
ゔぇると	ヴェルト	人名	
かふか	カフカ	人名	
くらーら	クラーラ	人名	
すゔぁろーぐ	スヴァローグ	人名	
さんぽ	サンポ	人名	
じぇぱーど	ジェパード	人名	
せーばる	セーバル	人名	
なたーしゃ	ナターシャ	人名	
ふっく	フック	人名	
ぶろーにゃ	ブローニャ	人名	
ぺら	ペラ	人名	
へるた	ヘルタ	人名	
るか	ルカ	人名	
りんくす	リンクス	人名	
みつきなのか	三月なのか	人名	
たんこう	丹恒	人名	
ていうん	停雲	人名	
じん	刃	人名	
ひめこ	姫子	人名	
げんきょう	彦卿	人名	
ぎょくう	御空	人名	
けいげん	景元	人名	
びゃくろ	白露	人名	
ふげん	符玄	人名	
すしょう	素裳	人名	
らせつ	羅刹	人名	
ぎんろう	銀狼	人名	
せいじゃく	青雀	人名	
いんげつ	飲月	人名	
けいりゅう	鏡流	人名	
とぱーず	トパーズ	人名	
けいないふん	桂乃芬	人名	
せつい	雪衣	人名	
かんあ	寒鴉	人名	
ふぉふぉ	フォフォ	人名	
あるじぇんてぃ	アルジェンティ	人名	
どくたーれいしお	Dr.レイシオ	人名	
ぶらっくすわん	ブラックスワン	人名	
みーしゃ	ミーシャ	人名	
はなび	花火	人名	
よみ	黄泉	人名	
あべんちゅりん	アベンチュリン	人名	
ろびん	ロビン	人名	
ぶーとひる	ブートヒル	人名	
ほたる	ホタル	人名	
じぇいど	ジェイド	人名	
うんり	雲璃	人名	
しょうきゅう	椒丘	人名	
ひしょう	飛霄	人名	
れいさ	霊砂	人名	
もぜ	モゼ	人名	
らんは	乱破	人名	（らっぱではないらしいです）
さんでー	サンデー	人名	
きぼうのさすらいびと	帰忘の流離人	人名	
さすらいびと	流離人	人名	
まだむへるた	マダム・ヘルタ	人名	
あぐらいあ	アグライア	人名	
とりびー	トリビー	人名	
もーでぃす	モーディス	人名	
きゃすとりす	キャストリス	人名	
あないくす	アナイクス	人名	
ひあんしー	ヒアンシー	人名	
さふぇる	サフェル	人名	
ふぁいのん	ファイノン	人名	
ながよづき	長夜月	人名	
とうこう	騰荒	人名	丹恒・騰荒
こうこう	爻光	人名	
ひばな	火花	人名	
しなず	不死途	人名	
すてら	虚照	人名	
ひえい	緋英	人名	
くちば	朽葉	人名	（実装されるかは不明）
ぱーる	パール	人名	（実装されるかは不明）

せい	星	人名	女性開拓者のデフォルト名。正確には「ベクター星」
きゅう	穹	人名	男性開拓者のデフォルト名。正確には「ベクター穹」。「そら」と読ませる可能性もある。

かいえん	懐炎	人名	仙舟の将軍の一人

! キャラクター名（フルネーム）
ゔぇるとよう	ヴェルト・ヨウ	人名	
さんぽこーすき	サンポ・コースキ	人名	
じぇぱーどらんどぅ	ジェパード・ランドゥ	人名	
せーばるらんどぅ	セーバル・ランドゥ	人名	
ぶろーにゃらんど	ブローニャ・ランド	人名	
りすしょう	李素裳	人名	
べりたすれいしお	ベリタス・レイシオ	人名	

! ロア関連用語
あいおーん	星神	固有名詞	この世界における神々
きょすうのき	虚数の樹	固有名詞	この世界のマルチバース理論の名称
ばんかいのがん	万界の癌	固有名詞	星核の別称
せいかく	星核	固有名詞	世界に壊滅をもたらすとされている物体
れっかい	裂界	固有名詞	星核がもたらす異世界
しんさくしょうぐん	神策将軍	固有名詞	景元の異名
むがんしょうぐん	無眼将軍	固有名詞	景元の異名
たいぼく	太卜	固有名詞	太卜司の長官に当たる役職
ぼくしゃ	卜者	固有名詞	太卜司の職員
うんきぐん	雲騎軍	固有名詞	仙舟の軍事組織
たいぼくし	太卜司	固有名詞	仙舟の行政組織で、高度な占いを基礎とする
ちこうし	地衡司	固有名詞	仙舟の治安組織
たんていし	丹鼎司	固有名詞	仙舟の医療組織
じゅうおうし	十王司	固有名詞	仙舟の刑務組織
こぞく	狐族	固有名詞	仙舟の長命種、もふもふ
じみょうぞく	持明族	固有名詞	仙舟の長命種、ドラゴン
ちょうわしゅうげん	調和衆弦	固有名詞	ファミリーの階級
きょうかんかくびーこん	共感覚ビーコン	固有名詞	どの星系の人でも言葉が通じる便利アイテム。要するに翻訳こんにゃく
こはくき	琥珀紀	固有名詞	西暦と違い、クリフォトが槌を振るった時に変わるので日本の和暦みたいなもの。
かいたくれき	開拓歴	固有名詞	1年を12の月に分けている。ペガーナのものを用いており、地球の太陽暦と同等。
しすてむじかん	システム時間	助数詞	実は1システム時間＝地球時間での1時間である
げんげつ	幻月	固有名詞	二相楽園の空に浮かぶ月
うい	初	固有名詞	二相楽園のそこらへんにいる四角い幻造種
げんぞうしゅ	幻造種	固有名詞	二相楽園で暮らす妖怪種のことを指す

! 地名
うちゅうすてーしょんへるた	宇宙ステーション「ヘルタ」	固有名詞	ヘルタの作った倉庫
やりーろ6	ヤリーロ-VI	固有名詞	ヤリーロ星系第6惑星
やリーろしっくす	ヤリーロ-VI	固有名詞	ヤリーロ星系第6惑星
せんしゅう	仙舟	固有名詞	
らふ	羅浮	固有名詞	
ぴのこにー	ピノコニー	固有名詞	
きちょうせきごう	暉長石号	固有名詞	名前はシナリオが進むと変わります
ようせい	曜青	固有名詞	
しゅめい	朱明	固有名詞	
ゆうしゅうごく	幽囚獄	固有名詞	
きょうほうかん	競鋒艦	固有名詞	
おんぱろす	オンパロス	固有名詞
にそうらくえん	二相楽園	固有名詞	
あはとぴあ	アハトピア	固有名詞	二相楽園がある星域
べんざいてんごく	弁財天国	固有名詞	二相楽園の過去の呼び名
きとくじょうとう	危篤冗棟	固有名詞	パブ「ワールド・エンド」にある病室

! 星神（アイオーン）
てるみぬす	テルミヌス	固有名詞	「終焉」の運命を司る星神
りゅう	龍	固有名詞	「不朽」の運命を司る星神
うろぼろす	ウロボロス	固有名詞	「貪欲」の運命を司る星神
あきゔぃり	アキヴィリ	固有名詞	「開拓」の運命を司る星神
ぬーす	ヌース	固有名詞	「知恵」の運命を司る星神
しぺ	シペ	固有名詞	「調和」の運命を司る星神
いどりら	イドリラ	固有名詞	「純美」の運命を司る星神
たいずるす	タイズルス	固有名詞	「繁殖」の運命を司る星神
みゅとぅす	ミュトゥス	固有名詞	「神秘」の運命を司る星神
ふー	互	固有名詞	「均衡」の運命を司る星神
くりふぉと	クリフォト	固有名詞	「存護」の運命を司る星神
ふり	浮黎	固有名詞	「記憶」の運命を司る星神
ないん	IX	固有名詞	「虚無」の運命を司る星神
やくし	薬師	固有名詞	「豊穣」の運命を司る星神
らん	嵐	固有名詞	「巡狩」の運命を司る星神
なぬーく	ナヌーク	固有名詞	「壊滅」の運命を司る星神
あっは	アッハ	固有名詞	「愉悦」の運命を司る星神

! 運命
そんご	存護	固有名詞	バリアタンク、バリアヒーラー
ほうじょう	豊穣	固有名詞	ピュアヒーラー
ちょうわ	調和	固有名詞	バッファー
きょむ	虚無	固有名詞	デバッファー
じゅんしゅ	巡狩	固有名詞	単体ダメージディーラー
ちえ	知恵	固有名詞	複数体ダメージディーラー
かいめつ	壊滅	固有名詞	万能ジョブ
きおく	記憶	固有名詞	召喚物ジョブ

しゅうえん	終焉	固有名詞	
ふきゅう	不朽	固有名詞	
どんよく	貪欲	固有名詞	
かいたく	開拓	固有名詞	
じゅんび	純美	固有名詞	
はんしょく	繁殖	固有名詞	
しんぴ	神秘	固有名詞	
きんこう	均衡	固有名詞	
ゆえつ	愉悦	固有名詞	

! 派閥
せいきゅうれっしゃ	星穹列車	固有名詞	開拓の運命
せいかくはんたー	星核ハンター	固有名詞	終焉の運命？
ななしびと	ナナシビト	固有名詞	開拓の運命
せんしゅうどうめい	仙舟同盟	固有名詞	巡狩の運命
じゅんかいれんじゃー	巡海レンジャー	固有名詞	巡狩の運命
こんとんいし	混沌医師	固有名詞	虚無の運命
だい9きかん	第IX機関	固有名詞	虚無の運命
だいきゅうきかん	第IX機関	固有名詞	虚無の運命
ほうじょうのたみ	豊穣の民	固有名詞	豊穣の運命
くすりごい	薬乞い	固有名詞	豊穣の運命
ほりじん	歩離人	固有名詞	豊穣の運命
はんぶっしつれぎおん	反物質レギオン	固有名詞	壊滅の運命
あないあれいとぎゃんぐ	アナイアレイトギャング	固有名詞	壊滅の運命
ふぁみりー	ファミリー	固有名詞	調和の運命
てんさいくらぶ	天才クラブ	固有名詞	知恵の運命
はくしきがっかい	博識学会	固有名詞	知恵の運命
けんそうしゃ	建創者	固有名詞	存護の運命
すたーぴーすかんぱにー	スターピースカンパニー	固有名詞	存護の運命
すうぉーむ	スウォーム	固有名詞	繁殖の運命
がーでんおぶりこれくしょん	ガーデン・オブ・リコレクション	固有名詞	記憶の運命
しょうきゃくじん	焼却人	固有名詞	記憶の運命
むろじょうし	無漏浄子	固有名詞	記憶の運命
とむらいれいじん	弔伶人	固有名詞	愉悦の運命
かめんのぐしゃ	仮面の愚者	固有名詞	愉悦の運命
みらーほるだー	ミラーホルダー	固有名詞	純美の運命
じゅんびのきしだん	純美の騎士団	固有名詞	純美の運命
きょこうれきしがくしゃ	虚構歴史学者	固有名詞	神秘の運命
りどらー	リドラー	固有名詞	神秘の運命
じめつしゃ	自滅者	固有名詞	虚無の運命
じゅうのせきしん	十の石心	固有名詞	存護の運営
てんがいせいかたい	天外聖歌隊	固有名詞	秩序の運命
そうぎきゃく	葬儀客	固有名詞	終焉の運命

! コンテンツ名
もぎうちゅう	模擬宇宙	固有名詞	ローグライクなエンドコンテンツ
ぎじかがく	疑似花萼	固有名詞	素材集め周回コンテンツ
ぎょうけつきょえい	凝結虚影	固有名詞	キャラクター昇格素材集めコンテンツ
しんしょくとんねる	侵蝕トンネル	固有名詞	遺物集めコンテンツ
れきせんよいん	歴戦余韻	固有名詞	週ボスコンテンツ
ぼうきゃくのにわ	忘却の庭	固有名詞	エンドコンテンツ（入門編の方）
こんとんのにわ	混沌の庭	固有名詞	真のエンドコンテンツ。通称「裏庭」
きょこうじょじ	虚構叙事	固有名詞	もう一つの真のエンドコンテンツ。雑魚無限湧きの方。
うちゅうのこうがい	宇宙の蝗害	固有名詞	模擬宇宙の第1回拡張。タイズルスと出会って虫退治するやつ
おうごんときかい	黄金と機械	固有名詞	模擬宇宙の第2回拡張。ヌースと出会って皇帝ルパートが何をしたのか探るやつ
かいさうちゅう	階差宇宙	固有名詞	模擬宇宙の第3回拡張。博識学会と協力して「人間界」をシミュレートしている
まつじつのげんえい	末日の幻影	固有名詞	さらなるエンドコンテンツ。強化されたボスを倒す

! 敵対者
げんろう	幻朧	人名	絶滅大君、壊滅の使令
もーどぅ	末度	人名	歩離人
ふーれい	呼雷	人名	歩離人
しつげま	死告魔	人名	v4.0時点では詳細不明な敵対者

! その他の基本用語
こうえんすい	光円錐	固有名詞	メイン装備
いぶつ	遺物	固有名詞	サブ装備
おうじつのむか	往日の夢華	固有名詞	課金石
せいぎょく	星玉	固有名詞	無課金の方の石
うんらく	殞落	名詞	死ぬこと。主に星神の死に対して用いる。
あづさか	集真赤	名詞	黄泉の必殺で使うやつ
ひこう	飛黄	名詞	飛霄の必殺で使うやつ
じんせい	靱性	名詞	
ぎじんせい	擬靱性	名詞	